0a00000000000000000000000000000000000000
0010111112000000000000000000000000000000
0030313132000000000000000000000000000000
0000000000000000000000000000000032320000
0000000000000000000000000000000032320000
0000000000000000000000000000000000000000
0000000000000000000000000000000000000000
0000000000000000000000000000000000000000
0000000000000000000000000000000000000000
0000000000000000000000000000000000000000
0300000000000000000000000000000000000000

0x44 1 2 34u16
hero @9,5
song song:feline_mind
image image:meadow
0x45 @2,4,4,5
0x28 @3,2
0x29 @7,7
0x2a @10,6
neighborn map:2
neighbore map:3
