21212121212121212121222a2b2b2b2b2b2b2b2b
21212121133131313131323a3b3b3b3b3b3b3b3b
2113313132030100000000000a08080a0a080a08
1332000000000001030101000802023f10120100
220002000000000200080a0a0a00040330320100
2200040301020006030902000200000100000101
2204040300001516161617000402001a1c010100
22000003000025262626270000001a2e2c000000
220403040004353636363701011a2e1d3c000100
2200000003010401020203021a2e1d3c02000000
2311120201040403010200002a2b2c0001000202

0x44 1 2 34u16
hero @8,7
song song:feline_mind
image image:meadow
neighbore map:2
neighbors map:4
