2121212121212121212122c0c1c2c3c4c5c2c3c4
2121212113313131313132d0d1d2d3d4d5d2d3d4
2113313132040403000200000a08080a0a080a08
1332000000020002010202000802023f10120100
220002808102000300080a0a0800030330320100
2200049091020006030902000302000100000101
2203030002011516161617000102041a1c010100
22000000020225262626270000041a2e2c000000
220000040400353636363701011a2e1d3c000100
2200000003010401020203021a2e1d3c02000000
2311120201040403010200002a2b2c0001000202

0x44 1 2 34u16
hero @8,7
song song:courage_quest
image image:meadow
neighbore map:2
neighbors map:4
