2121212121212121212121212121212121212121
2121212121212121212121212121212121212121
2121212121212113313131313131313131313131
2121133131313132020300020202000300010103
2113320202020302031011111111120210111111
3132010010111203022021212121220120212121
0203001024212202032021212113320030142121
0001022021212202032021212122000100202121
1111112421133201003014212122010300202121
2121212121220102010320212122020202202121
2121212121220302020020212123111111242121

image image:caves
neighbors map:8
sprite @15,8 sprite:chest item:RAFT 0 0 0
neighborw map:13
neighbore map:15
