2122010301020320212121211331313114212121
2123120000000230142121133200000030311421
2121220300000303202113320303030302023014
2121231203020302202122010003000303000030
2121212200010101202122000201000100000102
2121133200010000202122000203030001020300
3131320203020203202122000103030200020010
0201030001010310242123120301030002001024
1112020202011024212121231201020300002021
2122010101012021212121212311111111112421
2122000303002021212121212121212121212121

image image:caves
neighbore map:8
sprite @14,4 sprite:chest item:STOPWATCH 0 0 0
neighborn map:13
neighbors map:12
neighborw map:16
