2122030000032021212121212121212121212121
1332000101003031142121212121212121212121
2200020301000202301421212121212121212121
2201020110111200013014212121212121212121
2200020120212312000320211331313131313131
2203020220212123120130313203010302030300
2200020120212121220300010100101111111111
2311111124212121231111111111242121212121
2121212121212121212121212121212121212121
2121212121212121212121212121212121212121
2121212121212121212121212121212121212121

image image:caves
neighbore map:7
neighborn map:11
