2121212121212121212121212121212121212121
2121212121212121212121212121212121212121
3131313131313131311421212121212121212121
0202000000010303023014212121212121212121
1111111202020002030130313131313131142121
2121212202010000010200010303000001303131
2121133201020300000303010202020202030301
2113320201020101010200010103010201020101
2122000201020001000210111111111111111111
2122030203010300101124212121212121212121
2122000201020110242121212121212121212121

image image:caves
neighbore map:10
neighbors map:11
neighborw map:17
