0000022021212121212121212121212121212121
0000003031313131313131313131311421212121
0000030200030202010100020000002021212121
0202000300000000000000000000022021212121
1111120201000000000000000000022021212121
2121231203000000000000000002032021212121
2121212202020000000000000003102421212121
2121212312010303010303031011242121212121
2121212123111111120010112421212121212121
2121212121212121231124212121212121212121
2121212121212121212121212121212121212121

image image:caves
neighborw map:7
neighborn map:9
