2113313131313131313131313131313131313114
2122010301030301030202010100000103020320
3132030100010100010200010102010303030320
0202000101000002000302000000020000000320
1201030203020202030101010003030100010320
2203020103010000020203030203010302010020
2201030003020001030202020100010001010320
2201020002030200000102010002020301010220
2202000001030302000000010001020103010220
2202030103010201030202010002030300000220
2311111111111111111111111111111111111124

image image:caves
neighborw map:10
neighbors map:9
