2121212121212121212201202121212121212121
2121212121212121212201202121212121212121
2121212121212121212203202121212121212121
2121212121212121212202202121212121212121
2121212121212121212202301421212121212121
2121212121212121212203013014212121212121
2121212121212121212312020030313131313131
2121212121212121212123120301030101020203
2121212121212121212121231111111111111111
2121212121212121212121212121212121212121
2121212121212121212121212121212121212121

image image:caves
neighbore map:11
neighborn map:17
