2121212121212121212121212121212121212121
2121212121212121212121212121212121212121
2121212121212121211331313131313131313131
2121212121212121212201010303030102030301
2121212121212121212202101111111111111111
2121212121212121212201202121212121212121
2121212121212121212200202121212121212121
2121212121212121212201202121212121212121
2121212121212121212200202121212121212121
2121212121212121212200202121212121212121
2121212121212121212202202121212121212121

image image:caves
neighbore map:13
neighbors map:16
