c2c3c4c5c6c72021222a2b2b2b2b2b2b2b2b2b2b
d2d3d4d5d6d73014223a3b3b3b3b1e2b2b2b2b2b
0a080908090a08202200040002003a1e2b2b2b2b
0004000002000920220000000202002a2b2b2b2b
0000010004030820231111111112002a2b2b2b2b
0400000000000a30313131311422032a2b2b2b2b
0100828301030a0909080a082022023a3b3b3b3b
00009293000404010004000a2023111111111111
00020103030004020303000a3031313131313131
03000300030100000103000904000002001a1b1b
02010002000002000002000903000101022a2b2b

image image:meadow
neighborw map:start
neighbors map:3
