2b2b2b2b2b2b2c20222a2b2b2b2b2b2b2b2b2b2b
3b3b3b3b3b3b3c20223a3b3b3b3b1e2b2b2b2b2b
0a080908090a08202200040002003a1e2b2b2b2b
0104020004020920220000000202002a2b2b2b2b
0000000000030920231111111112002a2b2b2b2b
0000000000010930313131311422032a2b2b2b2b
0000000000000a0909080a082022023a3b3b3b3b
00000000000401010004000a2023111111111111
00000000000000000000030a3031313131313131
00000000000000000000010904000402001a1b1b
00000000000000000000020903000000042a2b2b

image image:meadow
neighborw map:start
neighbors map:3
