c2c3c4c5c6c72021222a2b2b2b2b2b2b2b2b2b2b
d2d3d4d5d6d73014223a3b3b3b3b1e2b2b2b2b2b
0a080908090a08202200040002003a1e2b2b2b2b
0004004d4e4f0920220000000202002a2b2b2b2b
0000015d5e5f0820231111111112002a2b2b2b2b
0400000000000a30313131311422032a2b2b2b2b
0100828301030a0909080a082022023a3b3b3b3b
00009293000404014d4e4f0a2023111111111111
04000103030004025d5e5f0a3031313131313131
1c000000030100000103000904000002001a1b1b
2d1c0302000002000002000903000101022a2b2b

image image:meadow
song song:courage_quest
neighborw map:start
neighbors map:3
door @4,4 map:5 @9,8 0 0
door @9,8 map:6 @9,8 0 0
