0000210000000000000000000000000000330000
0021210000000000000000000000000000333300
2121000000000000000000000000000000003333
0000000000000000111111110000000000000000
0000000000000011111111111100000000000000
0000000000000011111111111100000000000000
0000000000000000111111111100000000000000
0000000000000000000000000000000000000000
3300000011000000000000000000000000003333
0033000000000000000000000000000000333300
0000330000000000000000000000000000330000

image image:meadow
neighbors map:start
neighbore map:4
neighborw map:5
