0000000000000000000000000000000000000000
0000000000000000000000000000000000000000
0000000000002121212121000021210000000000
0000000000000000002121000021000000000000
0000000000000000212100000021210000000000
0000000000000000212121000021000000000000
0000000000000000000021000021210000000000
0000000000210000000021000000000000000000
0000000000212121212121000000000000000000
0000000000000000000000000000000000000000
0000000000000000000000000000000000000000

image image:meadow
neighborw map:start
neighborn map:4
door @11,7 map:8 @5,4 0 0
