00000000000000000000010a01000000012a2b2b
00000000000000000000000801000000022a2b2b
01000000000000010015170915170004002a2b2b
1b1c0102000000001529270925281701002a2b2b
2b2d1c00000000002526281629262700002a2b2b
2b2b2d1c030100032526262626262704022a2b2b
2b2b2b2d1c0001003519262626183700042a2b2b
2b2b2b2b2d1c020201353636363701001a2e2b2b
2b2b2b2b2b2d1c00020100010104011a2e2b2b2b
2b2b2b2b2b2b2d1b1b1b1b1b1b1b1b2e2b2b2b2b
2b2b2b2b2b2b2b2b2b2b2b2b2b2b2b2b2b2b2b2b

image image:meadow
neighborn map:2
neighborw map:4
