2121220400000000000000022a2b2c0200000000
2121220200000000000103012a2b2c0000000000
2121220200000000011a1b1b2e1d3c0300000003
2121220400000000012a2b1d3b3c00010400041a
2121231204020000002a2b2c00000403011a1b2e
21212123120100021a2e2b2c0404001a1b2e2b2b
21212121231200012a2b2b2d1b1b1b2e2b2b2b2b
21212121212202003a3b1e2b2b2b2b2b2b2b2b2b
212121212123111111123a1e2b2b2b2b2b2b2b2b
21212121212121212123122a2b2b2b2b2b2b2b2b
21212121212121212121222a2b2b2b2b2b2b2b2b

image image:meadow
neighborn map:start
neighbore map:3
