0000000000000000000000000000000000000000
0000000000000000000000000000000000000000
0000002100210000000000210021210000000000
0000002100210000002121210021000000000000
0000002121210000002121210021210000000000
0000000000210000002121210021000000000000
0000000000210000002100000021210000000000
0000000000000000000000000000000000000000
0000000000000000000000000000000000000000
0000000000000000000000000000000000000000
0000000000000000000000000000000000000000

image image:meadow
neighborw map:2
neighbors map:3
