2121220401030402000000022a2b2c0200000302
2121220202000300010103012a2b2c0400010002
2121220200000404011a1b1b2e1d3c0303020404
2121220400020202002a2b1d3b3c02020000011a
2121231204030300002a2b2c00030303011a1b2e
21212123120100021a2e2b2c0001031a1b2e2b2b
21212121231200012a2b2b2d1b1b1b2e2b2b2b2b
21212121212202003a3b1e2b2b2b2b2b2b2b2b2b
212121212123111111123a1e2b2b2b2b2b2b2b2b
21212121212121212123122a2b2b2b2b2b2b2b2b
21212121212121212121222a2b2b2b2b2b2b2b2b

image image:meadow
neighborn map:start
neighbore map:3
