0000000000000000000000000000000000000000
0000000000000000000000000000000000000000
0000000000000021212100000000000000000000
0000000000000021000000000000000000000000
0000000000000021212100000000000000000000
0000000000000000002100000000002121000000
0000000000000021212100000021002100000000
0000000000000000000000212121002121000000
0000000000000000000000212121002100000000
0000000000000000000000210000002121000000
0000000000000000000000000000000000000000

image image:meadow
neighbore map:4
neighborn map:6
neighborw map:7
