2121212121212121212121212121212121212121
2121212121212121212121212121212121212121
2121211331314331314331314331311421212121
2121212200005300005300005300002021212121
2121212200000000000000000000002021212121
2121212200000000000000000000002021212121
2121212200000000000000000000002021212121
2121212200000000404142000000002021212121
2121212311111111505152111111112421212121
2121212121212121212121212121212121212121
2121212121212121212121212121212121212121

image image:meadow_int
song song:secret_stone
door @9,8 map:2 @4,4 0 0
sprite @10,4 sprite:chest item:COMPASS 0 0 0
