2121212121212121212121212121212121212121
2121212121212121212121212121212121212121
2121212121212121212121212121212121212121
2121212121212121212121212121212121212121
2121212121133131313131311421212121212121
2121212121220000000000022021212121212121
2121212121220000000000002021212121212121
2121212121220000404142002021212121212121
2121212121231111505152112421212121212121
2121212121212121212121212121212121212121
2121212121212121212121212121212121212121

image image:meadow_int
song song:worms_lair
door @9,8 map:2 @9,8 0 0
sprite @7,6 sprite:chest item:BOMB 12 FLD_bombchest1 0
door @11,5 map:7 @11,5 0 0
