0000000000000000000000000000000000000000
0000000000212121212100000000000000000000
0000000000210000000000000000000000000000
0000000000210000000000000000000000000000
0000000000212121212100000000000000000000
0000000000210000002100000000000000000000
0000000000212121212100000000000000000000
0000000000000000000000000000000000000000
0000000000000000000000000000000000000000
0000000000000000000000000000000000000000
0000000000000000000000000000000000000000

image image:meadow
neighbors map:5
