0101010101010101010101010101010101010101
0101010101010101010101010101010101010101
0101010101010101010101010101010101010101
0101010101010101010101010101010101010101
0101010101111111111111111101010101010101
0101010101110000000000001101010101010101
0101010101110000000000001101010101010101
0101010101110000000000001101010101010101
0101010101111111110011111101010101010101
0101010101010101010101010101010101010101
0101010101010101010101010101010101010101

image image:meadow_int
song song:worms_lair
door @9,8 map:2 @9,8 0 0
