2121212121133132020100202121212121220201
2121212121220301030303303114212121220201
2113311421220300000303010130313131320203
2122022021220003000202030302030102010303
3132002021220102000001020101000203030110
0200012021231200010100040302000301000020
1111112421212203000000020001010300021024
2121212121212312020001000303030101102421
2121212121212123111202020310111111242121
2121212121212121212311111124212121212121
2121212121212121212121212121212121212121

door @11,5 map:6 @11,5 0 0
image image:caves
neighborn map:8
sprite @2,3 sprite:chest item:GOLD 10 FLD_cavegold1 0
neighborw map:12
neighbore map:14
