2113313131320100030030313131311421212121
1332020301000103030001030001003031142121
2200030100030300020100000103020001301421
3200020202101111111112030101010200033014
0203030010242121212123111203000000020230
0202000120212121212121212311111200020001
1200010030142121212121212121212203000301
2200000003303131313131313131313203000010
2312030100020102020003000302020001020120
2123120000010200030203020003030103011024
2121231111111112020203101111111111112421

image image:caves
neighbors map:7
neighbore map:9
neighborn map:10
neighborw map:11
