2121212121212121212121212121212121212121
2121212121212121212121212121212121212121
2121212121212121212121212121212121212121
2121212121212121212121212113313131142121
3131313114212121212121212122020200202121
0000030130313131142121212122010103202121
0303030100010101303131142122000000202121
1200030003020200010300303132020303202121
2202021011120002020002020103010201202121
2202002021231111120202000003010110242121
2201032021212121231111111111111124212121

image image:caves
neighborw map:8
neighbors map:14
sprite @15,5 sprite:chest item:SHIELD 0 0 0
neighborn map:15
